111111111111111111111111111111111111111
1                  2                 51
1               3  2                  1
1                  2                  1
1              11111                  1
1                                     1
1                                     1
1                                     1
1      212                    12      1
1      2  2                  2  1     1
1      2  2                  2  2     1
1      2  2                  2  1     1
1      2 52                  15 2     1
1      212                    112     1
1                                     1
1                                     1
1                                     1
1                                     1
1    2                           2    1
1  1 5 2                       1 5 1  1
1    1                           2    1
1                                     1
1  2222                        2222   1
1     22                      22      1
1       12                   22       1
1        22                 21        1
1          222222222222222222         1
1                                     1
1                                     1
1                                     1
1                                     1
1                                     1
1                                     1
1                                     1
1                                     1
1             121121                  1
1             2                       1
1             2  4                    1
15            2                       1
111111111111111111111111111111111111111